Name,Volume,Ask Size,Ask Price,Bid Size,Bid Price,Last Price,Shares Matched,Shares Routed
UVXY,6413187,0,0.00,0,0.00,14.40,6362365,50822
IEFA,2712147,0,0.00,0,0.00,64.32,2699106,13041
ARKG,2358481,0,0.00,0,0.00,32.59,2322181,36300
VIXY,1043858,0,0.00,0,0.00,17.92,1039518,4340
INDA,942784,0,0.00,0,0.00,41.43,915983,26801
ITB,940244,0,0.00,0,0.00,59.44,932946,7298
SVXY,786421,0,0.00,0,0.00,50.03,776331,10090
EZU,701807,0,0.00,0,0.00,40.58,698967,2840
GOVT,566458,0,0.00,0,0.00,23.95,566358,100
VXX,475102,0,0.00,0,0.00,24.65,466562,8540
BBEU,451147,0,0.00,0,0.00,51.18,449947,1200
USMV,414366,0,0.00,0,0.00,72.86,409465,4901
SVIX,347766,0,0.00,0,0.00,11.37,344916,2850
USHY,322565,0,0.00,0,0.00,36.17,322065,500
FGRO,316011,0,0.00,0,0.00,14.42,316011,0
EFV,296962,0,0.00,0,0.00,48.13,294564,2398
QUAL,257037,0,0.00,0,0.00,122.04,256465,572
IGV,223048,0,0.00,0,0.00,277.91,218734,4314
IGE,202808,0,0.00,0,0.00,41.46,200096,2712
BBJP,195668,0,0.00,0,0.00,46.52,183882,11786
COWZ,184502,0,0.00,0,0.00,50.00,180459,4043
EEMV,175288,0,0.00,0,0.00,56.84,172718,2570
JPST,169643,0,0.00,0,0.00,50.17,168223,1420
VLUE,166191,0,0.00,0,0.00,101.61,163596,2595
EFAV,165622,0,0.00,0,0.00,67.07,162705,2917
CBOE,150030,0,0.00,0,0.00,108.00,148678,1352
REM,144838,0,0.00,0,0.00,30.35,143238,1600
MTUM,138756,0,0.00,0,0.00,143.88,138453,303
UVIX,134910,0,0.00,0,0.00,17.51,131796,3114
ICVT,127660,0,0.00,0,0.00,72.87,127035,625
BBAX,123279,0,0.00,0,0.00,51.19,106604,16675
HYD,122209,0,0.00,0,0.00,53.23,122019,190
NOBL,96225,0,0.00,0,0.00,92.31,95777,448
AAAU,96161,0,0.00,0,0.00,18.04,95711,450
PAVE,93912,0,0.00,0,0.00,25.64,93508,404
BBCA,92488,0,0.00,0,0.00,64.16,92099,389
RYLD,92199,0,0.00,0,0.00,21.91,89836,2363
IYZ,90573,0,0.00,0,0.00,27.11,90573,0
IDV,86589,0,0.00,0,0.00,30.57,85684,905
ITA,79478,0,0.00,0,0.00,100.89,79371,107
MOAT,76360,0,0.00,0,0.00,68.72,67977,8383
ECH,72822,0,0.00,0,0.00,27.59,72453,369
HEFA,70523,0,0.00,0,0.00,33.38,70423,100
IEO,64970,0,0.00,0,0.00,92.09,64970,0
FLOT,61722,0,0.00,0,0.00,50.44,61113,609
ARKQ,53709,0,0.00,0,0.00,54.00,53694,15
ITM,50725,0,0.00,0,0.00,44.66,50725,0
EFG,50031,0,0.00,0,0.00,86.40,49323,708
ARKX,48971,0,0.00,0,0.00,14.73,48610,361
ICSH,46797,0,0.00,0,0.00,50.08,46797,0
JPHY,46540,0,0.00,0,0.00,45.28,46540,0
NEAR,45975,0,0.00,0,0.00,49.43,31887,14088
PICK,43727,0,0.00,0,0.00,43.47,43584,143
VNM,43639,0,0.00,0,0.00,15.74,43562,77
DIVB,37119,0,0.00,0,0.00,39.50,37119,0
GTIP,37003,0,0.00,0,0.00,53.50,37003,0
JEMA,34044,0,0.00,0,0.00,37.76,34044,0
DAPR,32816,0,0.00,0,0.00,30.33,32716,100
ESGV,32164,0,0.00,0,0.00,71.82,32163,1
MLN,31652,0,0.00,0,0.00,17.52,31652,0
ACWV,30898,0,0.00,0,0.00,98.41,28761,2137
JMST,30264,0,0.00,0,0.00,50.42,28988,1276
DFIC,28620,0,0.00,0,0.00,23.32,28620,0
SYLD,26648,0,0.00,0,0.00,62.99,26512,136
GSEW,25280,0,0.00,0,0.00,60.48,23480,1800
ICF,24937,0,0.00,0,0.00,63.58,24335,602
LQDI,24853,0,0.00,0,0.00,26.98,24853,0
RPHS,24534,0,0.00,0,0.00,9.11,24534,0
BUFT,24350,0,0.00,0,0.00,19.19,24350,0
PRNT,20443,0,0.00,0,0.00,22.62,20343,100
PMAY,20170,0,0.00,0,0.00,28.61,20070,100
FAPR,19950,0,0.00,0,0.00,29.83,19468,482
UJAN,19642,0,0.00,0,0.00,29.73,19342,300
PTLC,19099,0,0.00,0,0.00,37.52,19099,0
OGIG,18966,0,0.00,0,0.00,27.83,14757,4209
KNG,18456,0,0.00,0,0.00,53.35,18456,0
IAGG,18107,0,0.00,0,0.00,50.78,18019,88
IYT,18087,0,0.00,0,0.00,238.49,17224,863
TAIL,17667,0,0.00,0,0.00,16.80,10066,7601
BBUS,17484,0,0.00,0,0.00,73.33,17484,0
GCOW,16041,0,0.00,0,0.00,33.74,16038,3
BUFR,15670,0,0.00,0,0.00,22.26,13010,2660
SFIG,15107,0,0.00,0,0.00,47.99,15107,0
BBRE,14796,0,0.00,0,0.00,94.64,14686,110
CNYA,14760,0,0.00,0,0.00,33.24,14227,533
FMAY,14705,0,0.00,0,0.00,35.13,14705,0
NULV,14060,0,0.00,0,0.00,36.25,14060,0
CALF,13239,0,0.00,0,0.00,38.95,13238,1
GMOM,12943,0,0.00,0,0.00,31.49,12943,0
PBEE,12106,0,0.00,0,0.00,23.46,12106,0
FCPI,11927,0,0.00,0,0.00,32.59,11927,0
FFEB,11814,0,0.00,0,0.00,35.98,11814,0
BUFD,11630,0,0.00,0,0.00,20.14,11630,0
EMHY,11324,0,0.00,0,0.00,36.79,11324,0
IFRA,10600,0,0.00,0,0.00,37.15,9871,729
FDEC,10334,0,0.00,0,0.00,31.90,10334,0
JCPI,9985,0,0.00,0,0.00,49.23,9985,0
BBIN,9888,0,0.00,0,0.00,51.47,9888,0
OMFL,9854,0,0.00,0,0.00,45.28,9854,0
OUSM,9808,0,0.00,0,0.00,33.68,9808,0
DFIS,9751,0,0.00,0,0.00,22.84,9751,0
NUSC,9747,0,0.00,0,0.00,35.99,9747,0
VFVA,9484,0,0.00,0,0.00,102.96,9206,278
NULG,9135,0,0.00,0,0.00,51.26,9135,0
GSUS,9054,0,0.00,0,0.00,55.57,9054,0
VUSB,8905,0,0.00,0,0.00,49.33,8905,0
VSGX,8432,0,0.00,0,0.00,52.41,7233,1199
IYJ,8159,0,0.00,0,0.00,95.88,8059,100
NUMV,8137,0,0.00,0,0.00,34.28,8037,100
TMFC,8047,0,0.00,0,0.00,34.30,7547,500
VAMO,7638,0,0.00,0,0.00,26.97,7638,0
XSHD,7555,0,0.00,0,0.00,21.05,7552,3
FLV,7450,0,0.00,0,0.00,59.94,7361,89
DMAY,7310,0,0.00,0,0.00,32.44,7210,100
SLVP,7273,0,0.00,0,0.00,11.49,7076,197
DDWM,7224,0,0.00,0,0.00,30.13,7224,0
SMB,7058,0,0.00,0,0.00,16.81,7058,0
EMGF,7019,0,0.00,0,0.00,45.37,7019,0
MBCC,7003,0,0.00,0,0.00,23.45,7003,0
OUSA,6977,0,0.00,0,0.00,42.27,6977,0
MSTB,6753,0,0.00,0,0.00,27.17,6753,0
CEMB,6737,0,0.00,0,0.00,43.97,6081,656
OILK,6658,0,0.00,0,0.00,56.28,6658,0
EGIS,6636,0,0.00,0,0.00,32.10,6636,0
HYMU,6633,0,0.00,0,0.00,21.70,6633,0
FNOV,6582,0,0.00,0,0.00,35.58,6582,0
VIXM,6531,0,0.00,0,0.00,34.53,6531,0
FAUG,6437,0,0.00,0,0.00,35.72,6337,100
JMUB,6353,0,0.00,0,0.00,49.30,6353,0
SMMV,6292,0,0.00,0,0.00,34.97,6292,0
EWUS,6261,0,0.00,0,0.00,35.30,6261,0
VCEB,6228,0,0.00,0,0.00,63.40,6228,0
EPRF,6162,0,0.00,0,0.00,19.58,6162,0
ESML,6047,0,0.00,0,0.00,34.26,6047,0
FYLD,6030,0,0.00,0,0.00,26.28,6030,0
DISV,5891,0,0.00,0,0.00,23.10,5891,0
FBCG,5881,0,0.00,0,0.00,24.33,5881,0
PSFF,5841,0,0.00,0,0.00,21.47,5841,0
REGL,5671,0,0.00,0,0.00,71.32,5671,0
DNOV,5615,0,0.00,0,0.00,33.01,5615,0
DAUG,5531,0,0.00,0,0.00,33.10,5431,100
BUFG,5530,0,0.00,0,0.00,18.49,5530,0
DMAR,5454,0,0.00,0,0.00,30.84,5312,142
EUCG,5420,0,0.00,0,0.00,20.60,5420,0
BOB,5409,0,0.00,0,0.00,23.74,5409,0
NUEM,5405,0,0.00,0,0.00,27.93,1822,3583
IQDG,5344,0,0.00,0,0.00,32.83,5344,0
XMPT,5292,0,0.00,0,0.00,22.57,4992,300
SMMD,5283,0,0.00,0,0.00,56.35,4383,900
VFMO,5214,0,0.00,0,0.00,116.64,5214,0
YSEP,5142,0,0.00,0,0.00,18.25,5142,0
PSMC,5000,0,0.00,0,0.00,12.52,4700,300
FRDM,4978,0,0.00,0,0.00,30.62,4978,0
DIHP,4809,0,0.00,0,0.00,23.13,4809,0
PSEP,4808,0,0.00,0,0.00,28.75,4794,14
MOHR,4800,0,0.00,0,0.00,21.36,4800,0
FDG,4787,0,0.00,0,0.00,56.50,4787,0
ROMO,4713,0,0.00,0,0.00,25.98,4713,0
NUMG,4657,0,0.00,0,0.00,36.87,4657,0
LYFE,4609,0,0.00,0,0.00,30.24,4609,0
BMAY,4501,0,0.00,0,0.00,29.99,4001,500
KAPR,4438,0,0.00,0,0.00,25.20,4438,0
GVI,4408,0,0.00,0,0.00,105.97,4408,0
VXZ,4362,0,0.00,0,0.00,29.10,4362,0
SMIN,4325,0,0.00,0,0.00,52.09,4325,0
MAMB,4285,0,0.00,0,0.00,22.57,4135,150
FCLD,4244,0,0.00,0,0.00,16.52,3309,935
XSHQ,4129,0,0.00,0,0.00,33.42,3967,162
DRSK,4115,0,0.00,0,0.00,26.82,4115,0
MEAR,4002,0,0.00,0,0.00,49.60,4002,0
TMFG,3991,0,0.00,0,0.00,24.26,3991,0
SECT,3970,0,0.00,0,0.00,39.26,3970,0
SHYD,3921,0,0.00,0,0.00,22.19,3773,148
IGRO,3859,0,0.00,0,0.00,60.66,3859,0
MPRO,3700,0,0.00,0,0.00,25.99,3700,0
TTAC,3675,0,0.00,0,0.00,48.19,3675,0
BUFF,3662,0,0.00,0,0.00,34.07,3662,0
SMDV,3659,0,0.00,0,0.00,61.46,3659,0
DFNL,3622,0,0.00,0,0.00,28.04,3622,0
DDEC,3491,0,0.00,0,0.00,30.73,3491,0
ENOR,3349,0,0.00,0,0.00,27.25,3144,205
DSEP,3347,0,0.00,0,0.00,31.21,3347,0
HEEM,3325,0,0.00,0,0.00,25.87,1168,2157
IBMN,3238,0,0.00,0,0.00,26.17,3238,0
FAIL,3236,0,0.00,0,0.00,22.05,3236,0
IBHC,3164,0,0.00,0,0.00,23.59,3086,78
IGHG,3147,0,0.00,0,0.00,70.00,2821,326
VFQY,3112,0,0.00,0,0.00,106.97,2812,300
FRNW,3042,0,0.00,0,0.00,20.54,3042,0
WFHY,3019,0,0.00,0,0.00,46.01,3019,0
PNOV,3008,0,0.00,0,0.00,29.08,3008,0
GVAL,2991,0,0.00,0,0.00,20.06,2991,0
VOTE,2948,0,0.00,0,0.00,47.40,2948,0
FCTR,2937,0,0.00,0,0.00,29.76,2937,0
FDRV,2855,0,0.00,0,0.00,19.38,2855,0
PAUG,2821,0,0.00,0,0.00,28.87,2821,0
FBCV,2801,0,0.00,0,0.00,28.45,2801,0
JCPB,2776,0,0.00,0,0.00,48.40,2776,0
IBMP,2764,0,0.00,0,0.00,24.68,2764,0
DWLD,2755,0,0.00,0,0.00,24.94,2755,0
PJUN,2681,0,0.00,0,0.00,30.61,2681,0
XVV,2648,0,0.00,0,0.00,30.74,2648,0
EYLD,2620,0,0.00,0,0.00,29.05,2620,0
FLQL,2557,0,0.00,0,0.00,41.89,2557,0
GSST,2537,0,0.00,0,0.00,50.00,2537,0
XJR,2528,0,0.00,0,0.00,34.97,2528,0
FJUN,2465,0,0.00,0,0.00,35.45,2465,0
OEUR,2465,0,0.00,0,0.00,23.92,2465,0
BOCT,2380,0,0.00,0,0.00,31.86,2380,0
AESR,2363,0,0.00,0,0.00,12.06,2363,0
IGEB,2281,0,0.00,0,0.00,45.23,2281,0
GAA,2243,0,0.00,0,0.00,28.59,2243,0
IZRL,2225,0,0.00,0,0.00,19.67,2225,0
IBMM,2164,0,0.00,0,0.00,25.70,2164,0
PTNQ,2100,0,0.00,0,0.00,52.63,2100,0
KWT,2059,0,0.00,0,0.00,37.57,1959,100
LUXE,2052,0,0.00,0,0.00,22.66,2052,0
SVAL,2048,0,0.00,0,0.00,28.91,2048,0
QVAL,2003,0,0.00,0,0.00,35.89,2003,0
PAWZ,2002,0,0.00,0,0.00,55.78,2002,0
IBMO,1975,0,0.00,0,0.00,24.88,1875,100
MSVX,1970,0,0.00,0,0.00,26.04,1970,0
IDME,1956,0,0.00,0,0.00,21.05,1956,0
FJUL,1913,0,0.00,0,0.00,33.89,1913,0
IEME,1905,0,0.00,0,0.00,27.43,1404,501
DJUN,1871,0,0.00,0,0.00,32.76,1871,0
APXH,1866,0,0.00,0,0.00,8.68,1866,0
LVHI,1853,0,0.00,0,0.00,27.35,1853,0
VFMV,1848,0,0.00,0,0.00,99.79,1848,0
DFNV,1834,0,0.00,0,0.00,22.98,1834,0
JBBB,1825,0,0.00,0,0.00,46.00,1825,0
USMF,1816,0,0.00,0,0.00,39.09,1816,0
DUSA,1798,0,0.00,0,0.00,29.67,1798,0
EDEN,1781,0,0.00,0,0.00,91.14,1781,0
DFND,1766,0,0.00,0,0.00,34.50,1766,0
ACIO,1750,0,0.00,0,0.00,29.79,1750,0
IBML,1738,0,0.00,0,0.00,25.35,1738,0
IBHB,1701,0,0.00,0,0.00,23.99,1701,0
HEGD,1669,0,0.00,0,0.00,17.51,1669,0
NURE,1663,0,0.00,0,0.00,34.94,1663,0
PTMC,1659,0,0.00,0,0.00,34.53,1659,0
IGLD,1615,0,0.00,0,0.00,20.02,1615,0
IYLD,1615,0,0.00,0,0.00,20.72,1515,100
PJAN,1582,0,0.00,0,0.00,31.01,1582,0
PBUS,1581,0,0.00,0,0.00,40.77,1581,0
NUDM,1570,0,0.00,0,0.00,26.84,1570,0
FOCT,1550,0,0.00,0,0.00,32.76,1550,0
TOKE,1539,0,0.00,0,0.00,9.74,1539,0
BALT,1500,0,0.00,0,0.00,25.67,1500,0
FFSG,1470,0,0.00,0,0.00,32.94,1470,0
FLBL,1430,0,0.00,0,0.00,23.96,1430,0
JPIB,1422,0,0.00,0,0.00,46.65,1422,0
ADME,1419,0,0.00,0,0.00,37.27,1419,0
IBHG,1400,0,0.00,0,0.00,22.16,1000,400
DDLS,1399,0,0.00,0,0.00,32.14,1399,0
MRGR,1302,0,0.00,0,0.00,39.98,1302,0
FLHY,1295,0,0.00,0,0.00,23.03,1295,0
BJAN,1276,0,0.00,0,0.00,33.85,1276,0
XBTF,1267,0,0.00,0,0.00,29.28,1267,0
RULE,1240,0,0.00,0,0.00,21.37,1240,0
STOT,1213,0,0.00,0,0.00,46.89,1213,0
HFGO,1200,0,0.00,0,0.00,12.67,1200,0
PSMB,1186,0,0.00,0,0.00,15.32,986,200
FPRO,1147,0,0.00,0,0.00,23.51,1147,0
PEX,1144,0,0.00,0,0.00,29.34,1074,70
IBHE,1125,0,0.00,0,0.00,23.12,1125,0
DOCT,1115,0,0.00,0,0.00,31.24,1115,0
BUFB,1100,0,0.00,0,0.00,23.38,1100,0
AVDR,1099,0,0.00,0,0.00,26.40,1099,0
TDV,1098,0,0.00,0,0.00,58.14,1098,0
DINT,1096,0,0.00,0,0.00,16.07,1096,0
IETC,1083,0,0.00,0,0.00,46.05,1083,0
LEAD,1082,0,0.00,0,0.00,51.51,1082,0
OBND,1061,0,0.00,0,0.00,26.82,1061,0
FJAN,1060,0,0.00,0,0.00,32.80,1060,0
FMAR,1055,0,0.00,0,0.00,31.72,1055,0
FEDX,1031,0,0.00,0,0.00,25.67,1031,0
GLOV,1025,0,0.00,0,0.00,39.71,1025,0
PBTP,1024,0,0.00,0,0.00,26.16,1024,0
UMAY,1013,0,0.00,0,0.00,26.91,1013,0
FFHG,1011,0,0.00,0,0.00,32.86,1011,0
QMAR,1011,0,0.00,0,0.00,20.43,1011,0
IEDI,1004,0,0.00,0,0.00,38.27,1004,0
UFEB,1003,0,0.00,0,0.00,26.79,1003,0
RESD,1002,0,0.00,0,0.00,27.16,1002,0
TMFM,977,0,0.00,0,0.00,22.22,977,0
FDHT,975,0,0.00,0,0.00,18.54,775,200
FLDR,964,0,0.00,0,0.00,49.88,964,0
IVSG,904,0,0.00,0,0.00,10.77,904,0
PAPR,887,0,0.00,0,0.00,28.13,887,0
GOVZ,853,0,0.00,0,0.00,15.51,853,0
TMDV,819,0,0.00,0,0.00,47.12,819,0
IEHS,813,0,0.00,0,0.00,40.15,813,0
BAUG,800,0,0.00,0,0.00,30.59,800,0
DALT,794,0,0.00,0,0.00,9.49,794,0
MFUL,772,0,0.00,0,0.00,21.99,772,0
FMIL,707,0,0.00,0,0.00,29.21,707,0
PSFD,700,0,0.00,0,0.00,22.44,700,0
PTEU,683,0,0.00,0,0.00,22.36,683,0
LIV,680,0,0.00,0,0.00,18.30,680,0
PSCJ,679,0,0.00,0,0.00,19.89,679,0
FPFD,671,0,0.00,0,0.00,20.79,671,0
WEED,663,0,0.00,0,0.00,12.61,515,148
GCLN,661,0,0.00,0,0.00,36.53,661,0
QSPT,661,0,0.00,0,0.00,18.02,661,0
IBMQ,660,0,0.00,0,0.00,24.54,660,0
TYA,659,0,0.00,0,0.00,18.19,659,0
EFAD,647,0,0.00,0,0.00,36.89,647,0
IDHD,638,0,0.00,0,0.00,25.74,638,0
PMAR,636,0,0.00,0,0.00,30.70,636,0
DFRA,632,0,0.00,0,0.00,27.29,632,0
OSCV,630,0,0.00,0,0.00,31.14,630,0
ICOW,611,0,0.00,0,0.00,30.02,611,0
BNOV,606,0,0.00,0,0.00,29.82,606,0
GDE,600,0,0.00,0,0.00,22.20,600,0
IVAL,574,0,0.00,0,0.00,25.12,574,0
SATO,558,0,0.00,0,0.00,10.09,58,500
TMAT,541,0,0.00,0,0.00,13.81,541,0
BBSA,540,0,0.00,0,0.00,48.30,540,0
XBJL,528,0,0.00,0,0.00,25.39,528,0
TILT,527,0,0.00,0,0.00,158.49,527,0
NETZ,513,0,0.00,0,0.00,48.90,513,0
PJUL,512,0,0.00,0,0.00,29.32,512,0
UNOV,510,0,0.00,0,0.00,27.95,510,0
PSCQ,500,0,0.00,0,0.00,20.08,500,0
PSCW,500,0,0.00,0,0.00,21.12,500,0
POCT,499,0,0.00,0,0.00,28.94,499,0
UAPR,493,0,0.00,0,0.00,25.36,493,0
FLQM,492,0,0.00,0,0.00,42.02,492,0
MSMR,468,0,0.00,0,0.00,22.28,468,0
SEPZ,461,0,0.00,0,0.00,29.40,461,0
QDEC,460,0,0.00,0,0.00,20.02,260,200
MAGA,446,0,0.00,0,0.00,39.50,446,0
BFEB,445,0,0.00,0,0.00,30.21,445,0
IECS,440,0,0.00,0,0.00,34.57,440,0
NOVZ,435,0,0.00,0,0.00,30.20,435,0
IBHD,432,0,0.00,0,0.00,22.85,432,0
FSEP,427,0,0.00,0,0.00,33.17,427,0
GEMD,419,0,0.00,0,0.00,42.20,419,0
UJUL,402,0,0.00,0,0.00,26.16,402,0
DJAN,400,0,0.00,0,0.00,31.22,400,0
DJUL,400,0,0.00,0,0.00,31.59,400,0
NUDV,400,0,0.00,0,0.00,24.92,400,0
XTJA,400,0,0.00,0,0.00,20.94,0,400
WUGI,393,0,0.00,0,0.00,41.38,393,0
BJUN,372,0,0.00,0,0.00,31.92,372,0
CTRU,371,0,0.00,0,0.00,13.35,371,0
HELX,360,0,0.00,0,0.00,32.33,342,18
HAUS,346,0,0.00,0,0.00,18.65,346,0
XTOC,337,0,0.00,0,0.00,23.00,337,0
BSEP,336,0,0.00,0,0.00,30.54,336,0
HYDB,324,0,0.00,0,0.00,45.58,324,0
PLRG,301,0,0.00,0,0.00,24.81,301,0
EAOR,300,0,0.00,0,0.00,27.52,300,0
HSRT,300,0,0.00,0,0.00,38.60,300,0
KNGS,300,0,0.00,0,0.00,17.98,300,0
RTAI,300,0,0.00,0,0.00,21.50,300,0
XBJA,300,0,0.00,0,0.00,22.42,300,0
XTJL,300,0,0.00,0,0.00,24.50,300,0
FSMO,292,0,0.00,0,0.00,20.82,292,0
GHTA,280,0,0.00,0,0.00,22.71,280,0
AMER,275,0,0.00,0,0.00,28.84,275,0
SHAG,267,0,0.00,0,0.00,47.81,267,0
USEP,259,0,0.00,0,0.00,26.95,259,0
PFEB,258,0,0.00,0,0.00,27.97,58,200
AVDG,257,0,0.00,0,0.00,27.30,257,0
ESEB,255,0,0.00,0,0.00,17.15,255,0
DFEB,252,0,0.00,0,0.00,34.44,252,0
YPS,248,0,0.00,0,0.00,21.87,248,0
CSM,242,0,0.00,0,0.00,49.48,242,0
IEFN,240,0,0.00,0,0.00,29.74,239,1
XDAT,240,0,0.00,0,0.00,16.72,240,0
TRTY,226,0,0.00,0,0.00,26.86,226,0
EFNL,225,0,0.00,0,0.00,39.37,225,0
THY,223,0,0.00,0,0.00,23.70,223,0
YMAR,218,0,0.00,0,0.00,18.80,0,218
TMFS,217,0,0.00,0,0.00,25.11,217,0
WIL,215,0,0.00,0,0.00,87.34,210,5
GSEE,213,0,0.00,0,0.00,42.86,213,0
DURA,208,0,0.00,0,0.00,32.01,208,0
GDMN,205,0,0.00,0,0.00,25.57,205,0
NAPR,205,0,0.00,0,0.00,35.59,205,0
MRSK,203,0,0.00,0,0.00,27.19,203,0
ISVL,202,0,0.00,0,0.00,31.62,202,0
IMFL,201,0,0.00,0,0.00,22.48,201,0
PSMM,201,0,0.00,0,0.00,14.13,201,0
SPMV,201,0,0.00,0,0.00,37.32,201,0
IQM,200,0,0.00,0,0.00,37.27,200,0
MBND,200,0,0.00,0,0.00,26.63,200,0
PSCX,200,0,0.00,0,0.00,21.07,200,0
QJUN,200,0,0.00,0,0.00,18.97,200,0
QTOC,200,0,0.00,0,0.00,20.69,200,0
UAUG,200,0,0.00,0,0.00,27.57,200,0
BDEC,179,0,0.00,0,0.00,31.95,179,0
MOTI,175,0,0.00,0,0.00,30.22,175,0
TFJL,167,0,0.00,0,0.00,21.63,167,0
ESGG,166,0,0.00,0,0.00,129.19,166,0
BOSS,160,0,0.00,0,0.00,24.75,160,0
HYHG,153,0,0.00,0,0.00,59.03,153,0
XDEC,153,0,0.00,0,0.00,28.96,153,0
UDEC,150,0,0.00,0,0.00,28.51,150,0
QMOM,146,0,0.00,0,0.00,47.48,146,0
VFMF,143,0,0.00,0,0.00,99.84,143,0
PBSM,141,0,0.00,0,0.00,33.21,141,0
BJUL,138,0,0.00,0,0.00,30.90,138,0
IMOM,134,0,0.00,0,0.00,27.22,134,0
WBAT,130,0,0.00,0,0.00,36.53,130,0
XJH,130,0,0.00,0,0.00,33.59,130,0
GHYG,127,0,0.00,0,0.00,42.87,127,0
BUYZ,126,0,0.00,0,0.00,23.12,126,0
ESG,126,0,0.00,0,0.00,97.71,126,0
PBND,119,0,0.00,0,0.00,22.94,119,0
PSMG,118,0,0.00,0,0.00,17.17,118,0
FMAG,115,0,0.00,0,0.00,19.41,115,0
FUNL,115,0,0.00,0,0.00,33.77,115,0
BAPR,104,0,0.00,0,0.00,31.60,4,100
FIBR,104,0,0.00,0,0.00,86.96,104,0
GSID,104,0,0.00,0,0.00,48.80,104,0
FFTI,103,0,0.00,0,0.00,21.40,103,0
BLKC,102,0,0.00,0,0.00,13.76,102,0
DBJA,102,0,0.00,0,0.00,25.69,102,0
TTAI,102,0,0.00,0,0.00,29.75,102,0
ADFI,101,0,0.00,0,0.00,8.60,101,0
CEFS,101,0,0.00,0,0.00,18.11,101,0
PDEC,101,0,0.00,0,0.00,29.63,101,0
ATMP,100,0,0.00,0,0.00,19.95,100,0
DBOC,100,0,0.00,0,0.00,28.09,100,0
DFHY,100,0,0.00,0,0.00,22.42,100,0
DSOC,100,0,0.00,0,0.00,29.11,100,0
EMTL,100,0,0.00,0,0.00,42.44,100,0
FFTG,100,0,0.00,0,0.00,26.42,100,0
FLIA,100,0,0.00,0,0.00,23.49,100,0
NULC,100,0,0.00,0,0.00,34.48,100,0
OCTZ,100,0,0.00,0,0.00,29.44,100,0
RSEE,100,0,0.00,0,0.00,24.65,100,0
TSJA,100,0,0.00,0,0.00,25.25,100,0
YDEC,100,0,0.00,0,0.00,19.47,0,100
ZECP,99,0,0.00,0,0.00,23.64,99,0
MOTG,92,0,0.00,0,0.00,33.80,92,0
KJAN,83,0,0.00,0,0.00,29.48,83,0
QPFF,83,0,0.00,0,0.00,36.63,83,0
RESE,68,0,0.00,0,0.00,29.84,68,0
XDAP,61,0,0.00,0,0.00,26.64,61,0
IVDG,57,0,0.00,0,0.00,9.93,57,0
GLDB,54,0,0.00,0,0.00,20.46,54,0
AGT,53,0,0.00,0,0.00,26.26,53,0
QTJL,53,0,0.00,0,0.00,21.72,53,0
NJUL,52,0,0.00,0,0.00,44.37,52,0
ROCI,50,0,0.00,0,0.00,22.49,50,0
OMFS,49,0,0.00,0,0.00,36.10,49,0
XJUN,47,0,0.00,0,0.00,29.51,47,0
UOCT,41,0,0.00,0,0.00,27.22,41,0
NOCT,40,0,0.00,0,0.00,36.37,40,0
LKOR,37,0,0.00,0,0.00,45.29,37,0
IPDP,30,0,0.00,0,0.00,15.07,30,0
PXUS,25,0,0.00,0,0.00,21.75,25,0
PUNK,22,0,0.00,0,0.00,19.50,22,0
YJUN,22,0,0.00,0,0.00,18.85,22,0
USEQ,16,0,0.00,0,0.00,35.09,16,0
DUDE,15,0,0.00,0,0.00,25.55,15,0
BLDG,13,0,0.00,0,0.00,28.52,13,0
HYXU,12,0,0.00,0,0.00,45.03,12,0
IAUF,12,0,0.00,0,0.00,55.32,12,0
EMDV,8,0,0.00,0,0.00,48.62,8,0
XBOC,6,0,0.00,0,0.00,23.57,6,0
EWGS,4,0,0.00,0,0.00,65.06,4,0
AFIF,3,0,0.00,0,0.00,9.00,3,0
FDEV,3,0,0.00,0,0.00,25.37,3,0
IVRA,3,0,0.00,0,0.00,15.55,3,0
EUDV,2,0,0.00,0,0.00,43.71,2,0
FLQS,2,0,0.00,0,0.00,33.34,2,0
KJUL,2,0,0.00,0,0.00,24.68,2,0
KOCT,2,0,0.00,0,0.00,25.03,2,0
MAAX,2,0,0.00,0,0.00,21.22,2,0
NJAN,2,0,0.00,0,0.00,37.41,2,0
RDFI,2,0,0.00,0,0.00,23.44,2,0
UJUN,2,0,0.00,0,0.00,27.69,2,0
WFIG,2,0,0.00,0,0.00,45.61,2,0
XDQQ,2,0,0.00,0,0.00,23.53,2,0
MBBB,1,0,0.00,0,0.00,21.24,1,0
STLG,1,0,0.00,0,0.00,31.46,1,0
ACSI,0,0,0.00,0,0.00,0.00,0,0
ALFA,0,0,0.00,0,0.00,0.00,0,0
APRZ,0,0,0.00,0,0.00,0.00,0,0
ARCM,0,0,0.00,0,0.00,0.00,0,0
AUGZ,0,0,0.00,0,0.00,0.00,0,0
BGLD,0,0,0.00,0,0.00,0.00,0,0
BMAR,0,0,0.00,0,0.00,0.00,0,0
CFCV,0,0,0.00,0,0.00,0.00,0,0
CLSE,0,0,0.00,0,0.00,0.00,0,0
CVAR,0,0,0.00,0,0.00,0.00,0,0
DECZ,0,0,0.00,0,0.00,0.00,0,0
DSJA,0,0,0.00,0,0.00,0.00,0,0
EAOA,0,0,0.00,0,0.00,0.00,0,0
EAOK,0,0,0.00,0,0.00,0.00,0,0
EAOM,0,0,0.00,0,0.00,0.00,0,0
EOPS,0,0,0.00,0,0.00,0.00,0,0
ESCR,0,0,0.00,0,0.00,0.00,0,0
ESHY,0,0,0.00,0,0.00,0.00,0,0
FDEM,0,0,0.00,0,0.00,0.00,0,0
FEBZ,0,0,0.00,0,0.00,0.00,0,0
FLTN,0,0,0.00,0,0.00,0.00,0,0
FOMO,0,0,0.00,0,0.00,0.00,0,0
FPAG,0,0,0.00,0,0.00,0.00,0,0
GPAL,0,0,0.00,0,0.00,0.00,0,0
HCRB,0,0,0.00,0,0.00,0.00,0,0
HEET,0,0,0.00,0,0.00,0.00,0,0
HSUN,0,0,0.00,0,0.00,0.00,0,0
HYBL,0,0,0.00,0,0.00,0.00,0,0
HYIN,0,0,0.00,0,0.00,0.00,0,0
IBHF,0,0,0.00,0,0.00,0.00,0,0
IBHH,0,0,0.00,0,0.00,0.00,0,0
IBHI,0,0,0.00,0,0.00,0.00,0,0
IEIH,0,0,0.00,0,0.00,0.00,0,0
IMLP,0,0,0.00,0,0.00,0.00,0,0
IPPP,0,0,0.00,0,0.00,0.00,0,0
IVLC,0,0,0.00,0,0.00,0.00,0,0
JANZ,0,0,0.00,0,0.00,0.00,0,0
JULZ,0,0,0.00,0,0.00,0.00,0,0
JUNZ,0,0,0.00,0,0.00,0.00,0,0
MARZ,0,0,0.00,0,0.00,0.00,0,0
MAYZ,0,0,0.00,0,0.00,0.00,0,0
MBNE,0,0,0.00,0,0.00,0.00,0,0
MDEV,0,0,0.00,0,0.00,0.00,0,0
MIG,0,0,0.00,0,0.00,0.00,0,0
MINN,0,0,0.00,0,0.00,0.00,0,0
MOTE,0,0,0.00,0,0.00,0.00,0,0
MSTQ,0,0,0.00,0,0.00,0.00,0,0
PBDM,0,0,0.00,0,0.00,0.00,0,0
PLTL,0,0,0.00,0,0.00,0.00,0,0
PSFJ,0,0,0.00,0,0.00,0.00,0,0
PSFM,0,0,0.00,0,0.00,0.00,0,0
PSFO,0,0,0.00,0,0.00,0.00,0,0
PSMD,0,0,0.00,0,0.00,0.00,0,0
PSMJ,0,0,0.00,0,0.00,0.00,0,0
PSMO,0,0,0.00,0,0.00,0.00,0,0
PSMR,0,0,0.00,0,0.00,0.00,0,0
PWS,0,0,0.00,0,0.00,0.00,0,0
QCON,0,0,0.00,0,0.00,0.00,0,0
QLC,0,0,0.00,0,0.00,0.00,0,0
QTAP,0,0,0.00,0,0.00,0.00,0,0
QTJA,0,0,0.00,0,0.00,0.00,0,0
REC,0,0,0.00,0,0.00,0.00,0,0
RODE,0,0,0.00,0,0.00,0.00,0,0
RODI,0,0,0.00,0,0.00,0.00,0,0
RSX,0,0,0.00,0,0.00,0.00,0,0
RSXJ,0,0,0.00,0,0.00,0.00,0,0
SMI,0,0,0.00,0,0.00,0.00,0,0
STLV,0,0,0.00,0,0.00,0.00,0,0
TBJL,0,0,0.00,0,0.00,0.00,0,0
TCTL,0,0,0.00,0,0.00,0.00,0,0
TRDF,0,0,0.00,0,0.00,0.00,0,0
TSOC,0,0,0.00,0,0.00,0.00,0,0
UMAR,0,0,0.00,0,0.00,0.00,0,0
VFLQ,0,0,0.00,0,0.00,0.00,0,0
VIRS,0,0,0.00,0,0.00,0.00,0,0
VMOT,0,0,0.00,0,0.00,0.00,0,0
VWID,0,0,0.00,0,0.00,0.00,0,0
WDNA,0,0,0.00,0,0.00,0.00,0,0
WLDR,0,0,0.00,0,0.00,0.00,0,0
WTAI,0,0,0.00,0,0.00,0.00,0,0
XBAP,0,0,0.00,0,0.00,0.00,0,0
XDJA,0,0,0.00,0,0.00,0.00,0,0
XDJL,0,0,0.00,0,0.00,0.00,0,0
XDOC,0,0,0.00,0,0.00,0.00,0,0
XDSQ,0,0,0.00,0,0.00,0.00,0,0
XTAP,0,0,0.00,0,0.00,0.00,0,0